NO ./texture1.jsp
SO ./texture2.jsp
WE ./texture3.jsp




EA ./texture4.jsp




F 255,255,255


C 1,1,1






111111111111111111
10000000000000000111
111100000000000000001
   10000000N000000001
   100000000000000001
11100000000000000001
111111111111111111