EA ./home/pespana/Downloads/beautiful-bengal-cat.jpg
NO ./home/pespana/Downloads/nationalgeographic_1468962.webp
SO ./home/pespana/Downloads/nationalgeographic_1468962.webp
WE ./home/pespana/Downloads/beautiful-bengal-cat.jpg


C 255,255,255


F 0,0,0


1111111111111111111111111111
11000000000000000000000000001
10000S00000000000000000111111
100000000000000000000000000001
10000000011111111111111111111
111111111