NE ./texture1.jsp
SO ./texture2.jsp
EA ./texture3.jsp
WE ./texture4.jsp

F 255,255,255
C 0,0,0

111111111111111111
100000000000000001
100000000000000001
10000000N000000001
100000000000000001
100000000000000001
111111111111111111