EA /home/pespana/Downloads/cat1.png
NO /home/pespana/Downloads/cat2.png
SO /home/pespana/Downloads/cat2.png
WE /home/pespana/Downloads/cat1.png


C 255,255,255


F 0,0,0


11111111111111111111111111
110000000000000000000100001
10000S0000000100000011111
1000000000001 1000001000011
100000000000010000000000001
111111111111111111111111111