EA ./texture4.jsp
NO ./texture1.jsp
SO ./texture2.jsp
WE ./texture3.jsp


F    25   5,3,55


C 1,1,1                                                                                                                                             45





1111111111111111111111111111
11000000000000000000000000001
10000S00000000000000000111111
100000000000000000000000000001
10000000011111111111111111111
111111111