EA /home/pespana/Downloads/cat1.png
NO /home/pespana/Downloads/cat2.png
SO /home/pespana/Downloads/cat2.png
WE /home/pespana/Downloads/cat1.png


C 255,255,255


F 0,0,0


1111111111111111111111111111
11000000000100000000000000001
10000S00001 10010000000111111
100000000001000000000000000001
100000000000001111111111111111
111111111111111