EA /home/pespana/Downloads/cat1.png
NO /home/pespana/Downloads/cat2.png
SO /home/pespana/Downloads/cat2.png
WE /home/pespana/Downloads/cat1.png


C 255,255,255


F 0,0,0


11111111111111111111111111
110000000000000000000100001
10000S000000000000000111111
100000000000000000001000011
100000000000001111111111111
111111111111111