NO ./texture1.jsp
SO ./texture2.jsp
WE ./texture3.jsp
EA ./texture4.jsp


F    25   5,3,55


C 1,1,1                                                                                                                                             45






111111111111111111
100000000000000001
10000000000000000E1
10000000W000000001
100000000000000001
111000000000000001
111111111111111111